0000031300000
0303033303030
0303000003030
0303030303030
0303030303030
0100233320010
9133000003319
0100233320010
0303030303030
0303030303030
0303000003030
0303033303030
0000031300000
